%%%%%%%%%%
%%       %
%    %   %
%    %   %
%%%      %
%        %
%%    %  %
%%  % %  %
% % %    %
%  .% %  %
%        %
%      % %
%   %%%  %
%        %
%  %     %
%      P %
%   % %% %
%%    %% %
%      % %
%%%%%%%%%%
